6 6 6 6 6 6 6 6 6 6 6 6 6 6 6 6 6 6 6 6 6 6 6 6 6 2 2 2 6 6 6 6 6 6 6 6 6 6 6 6 6 6 6 6 6 6 6 6 6 6 6 6 6 6 6 6 6 6 6 6
6 0 0 0 0 0 0 0 0 0 0 0 0 0 0 0 0 0 0 0 0 0 0 0 0 2 2 2 0 0 0 0 0 0 0 0 0 0 0 0 0 1 1 1 1 1 1 1 1 1 1 1 1 1 1 1 1 1 1 6
6 0 0 0 0 0 0 0 0 0 0 0 0 0 0 0 0 0 0 0 0 0 0 0 0 2 2 2 0 0 0 0 0 0 0 0 0 0 0 0 0 1 4 4 4 4 4 4 4 4 4 4 4 4 4 4 4 4 1 6
6 0 0 0 0 0 0 0 0 0 0 0 0 0 0 0 0 0 0 0 0 0 0 0 0 2 2 2 0 0 0 0 0 0 0 0 0 0 0 0 0 1 4 4 4 1 1 1 1 1 1 1 1 1 1 1 1 4 1 6
6 0 0 0 5 5 5 0 0 0 0 0 0 0 0 0 0 0 0 0 0 0 0 0 0 2 2 2 0 0 0 0 0 0 0 0 0 0 0 0 0 1 4 4 4 1 4 4 4 4 4 4 4 4 4 4 4 4 1 6
6 0 0 0 5 5 5 5 5 5 5 5 5 5 5 5 5 5 5 5 5 0 0 0 0 2 2 2 0 0 0 0 0 0 0 0 0 0 0 0 0 1 4 4 4 1 4 4 4 4 4 4 4 4 4 4 4 4 1 6
6 0 0 0 5 5 5 0 0 0 0 0 0 0 0 0 0 0 0 0 5 0 0 0 0 2 2 2 0 0 0 0 0 0 0 0 0 0 0 0 0 1 4 4 4 1 4 4 4 4 4 4 4 4 4 4 4 4 1 6
6 0 0 0 0 0 0 0 0 0 0 0 0 0 0 0 0 0 0 0 5 0 0 0 0 2 2 2 0 0 0 0 0 0 0 0 0 0 0 0 0 1 4 4 4 1 4 4 4 4 4 4 4 4 4 4 4 4 1 6
6 0 0 0 0 0 0 0 0 0 0 0 0 0 0 0 0 0 0 0 5 0 0 0 0 2 2 2 0 0 0 0 0 0 0 0 0 0 0 0 0 1 4 4 4 1 4 1 1 1 1 1 1 1 1 1 1 1 1 6
6 0 0 0 0 0 0 0 0 0 0 0 0 0 0 0 0 0 0 0 5 0 0 0 0 2 2 2 0 0 0 0 0 0 0 0 0 0 0 0 0 1 4 4 4 1 4 4 4 4 4 4 4 4 4 4 4 4 1 6
6 1 1 1 1 1 1 1 1 1 1 1 1 1 1 1 1 1 1 0 5 0 0 0 0 2 2 2 0 5 5 5 5 5 5 5 5 5 5 5 5 0 4 4 4 1 4 4 4 4 4 4 4 4 4 4 4 4 1 6
6 0 0 0 0 0 0 0 0 0 0 0 0 0 0 0 0 0 0 0 5 0 0 0 0 2 2 2 0 5 0 0 0 0 0 0 0 0 0 0 0 1 4 4 4 1 4 4 4 4 4 4 4 4 4 4 4 4 1 6
6 0 0 0 0 0 0 0 0 0 0 0 0 0 0 0 0 0 0 0 5 0 0 0 0 2 2 2 0 5 0 0 0 0 0 0 0 0 0 0 0 1 4 4 4 1 4 4 4 4 4 4 4 4 4 4 4 4 1 6
6 0 0 0 0 0 0 0 0 0 0 0 0 0 0 0 0 0 0 0 5 0 0 0 0 2 2 2 0 5 0 0 0 0 0 0 0 0 0 0 0 1 4 4 4 1 1 1 1 1 1 1 1 1 1 1 1 4 1 6
6 0 0 0 0 0 0 0 0 0 0 0 0 0 0 0 0 0 0 0 5 0 0 0 0 2 2 2 0 5 0 1 1 1 1 1 1 1 1 1 1 1 1 1 1 1 1 4 4 4 4 4 4 4 4 4 4 4 1 6
6 0 0 0 5 5 5 5 5 5 5 5 5 5 5 5 5 5 5 5 5 0 0 0 0 2 2 2 0 5 0 1 7 7 7 7 7 7 7 7 7 7 7 7 7 7 1 4 4 4 4 4 4 4 4 4 4 4 1 6
6 0 0 0 5 0 0 0 0 0 0 0 0 0 0 0 0 0 0 0 0 0 0 0 0 2 2 2 0 5 0 1 7 7 7 7 7 7 7 7 7 7 7 7 7 7 1 4 4 4 4 4 4 4 4 4 4 4 1 6
6 0 0 0 5 0 0 0 0 0 0 0 0 0 0 0 0 0 0 0 0 0 0 0 0 2 2 2 0 5 0 1 7 7 7 7 7 7 7 7 7 7 7 7 7 7 1 4 4 4 4 4 4 4 4 4 4 4 1 6
6 0 0 0 5 0 0 0 0 0 0 0 0 0 0 0 0 0 0 0 0 0 0 0 0 2 2 2 0 5 0 1 7 4 7 7 7 7 7 7 7 7 7 7 7 7 1 4 4 4 4 4 4 4 4 4 4 4 1 6
6 0 0 0 5 0 1 1 1 1 1 1 1 1 1 1 1 1 1 1 1 1 1 1 1 2 2 2 0 5 0 1 7 7 7 7 7 7 7 7 7 7 7 7 7 7 1 4 4 4 4 4 4 4 4 4 4 4 1 6
6 0 0 0 5 0 0 0 0 0 0 0 0 0 0 0 0 0 0 0 0 0 0 0 0 2 2 2 0 5 0 1 7 7 7 7 7 7 7 7 7 7 7 7 7 7 1 4 4 4 4 4 4 4 4 4 4 4 1 6
6 0 0 0 5 0 0 0 0 0 0 0 0 0 0 0 0 0 0 0 0 0 0 0 0 2 2 2 0 5 0 1 7 7 7 7 7 7 7 7 7 7 7 7 7 7 4 4 4 4 4 4 4 4 4 4 4 4 1 6
6 0 0 0 5 5 5 5 5 5 5 5 5 5 5 5 5 5 5 5 5 0 0 0 0 2 2 2 0 5 0 1 1 1 1 1 1 1 1 1 1 1 1 1 1 1 1 4 4 4 4 4 4 4 4 4 4 4 1 6
6 0 0 0 0 0 0 0 0 0 0 0 0 0 0 0 0 0 0 0 5 0 0 0 0 2 2 2 0 5 0 0 0 0 0 0 0 0 0 0 0 0 0 0 0 0 1 1 1 1 1 1 1 1 1 1 1 1 1 6
6 0 0 0 0 0 0 0 3 3 3 3 0 0 0 0 0 0 0 0 5 0 0 0 0 2 2 2 0 5 0 0 0 0 0 0 0 0 0 0 0 0 0 0 0 0 0 0 0 0 0 0 0 0 0 0 0 0 0 6
6 0 0 0 0 3 3 3 3 2 2 2 2 3 0 0 0 0 0 0 5 0 0 0 0 2 2 2 0 5 0 0 0 0 0 0 0 0 0 0 0 0 0 0 0 0 0 0 0 0 0 0 0 0 0 0 0 0 0 6
6 0 0 3 3 2 2 2 2 2 2 2 2 2 0 0 0 0 0 0 5 0 0 0 0 2 2 2 0 5 0 0 0 0 0 0 0 0 0 0 0 0 0 0 0 0 0 0 0 0 0 0 0 0 0 0 0 0 0 6
6 3 3 2 2 2 2 2 2 2 2 2 2 2 0 0 0 0 0 0 5 0 0 0 0 2 2 2 0 5 5 5 5 5 5 5 5 5 5 5 5 5 5 5 5 5 5 5 5 5 5 5 5 5 5 5 5 5 0 6
6 2 2 2 2 2 2 2 2 2 2 2 2 2 3 0 0 0 0 0 5 0 0 0 0 2 2 2 0 0 0 0 0 0 0 0 0 0 0 0 0 0 0 0 0 0 0 0 0 0 0 0 0 0 0 0 0 5 0 6
6 2 2 2 2 2 2 2 2 2 2 2 2 2 3 0 0 0 0 0 5 0 0 0 0 2 2 2 0 0 0 0 0 0 0 0 0 0 0 0 0 0 0 0 0 0 0 0 0 0 0 0 0 0 0 0 0 5 0 6
6 2 2 2 2 2 2 2 2 2 2 2 2 2 2 3 3 0 0 0 5 0 0 0 0 2 2 2 0 0 0 0 0 0 0 0 0 0 6 6 6 0 0 0 0 0 0 0 0 0 0 0 0 0 0 0 0 5 0 6
6 2 2 2 2 2 2 2 2 2 2 2 2 2 2 3 3 3 3 0 5 0 0 0 0 2 2 2 0 6 6 6 6 6 6 6 6 6 6 6 6 6 6 6 6 6 6 6 0 0 0 0 0 0 0 0 0 5 0 6
6 2 2 2 2 2 2 3 3 3 3 2 2 2 2 2 2 2 3 3 7 3 3 0 0 2 2 2 6 6 6 6 6 6 6 6 6 6 6 6 6 6 6 6 6 6 6 6 6 6 6 6 6 0 0 0 0 5 0 6
6 2 2 2 2 3 3 3 3 3 3 3 3 2 2 2 2 2 2 2 7 2 0 3 3 2 2 2 0 0 0 0 0 0 0 0 0 0 0 6 6 6 6 6 6 0 0 0 0 0 0 0 6 6 6 6 6 0 0 6
6 2 2 2 2 3 3 3 3 3 3 3 3 2 2 2 2 2 2 2 7 2 2 2 2 2 2 2 0 0 0 0 0 6 6 6 6 6 0 6 6 6 6 6 6 0 6 6 6 6 6 0 6 6 6 6 6 0 6 6
6 2 7 7 7 3 3 3 3 3 3 3 3 3 3 3 3 2 2 2 7 2 2 2 2 2 2 2 0 0 0 0 0 0 6 6 6 6 0 6 6 6 6 6 6 0 6 0 0 6 6 0 6 6 6 6 6 0 6 6
6 2 7 2 2 3 3 3 3 3 3 3 3 3 3 3 3 3 3 3 7 2 2 2 2 2 2 2 0 0 0 0 0 0 6 6 6 6 0 6 6 6 6 6 6 0 6 0 0 0 0 0 6 6 6 6 6 0 6 6
6 2 7 2 2 2 2 2 3 3 3 3 3 3 3 3 3 3 3 2 2 2 2 2 2 2 2 2 0 0 0 0 0 0 6 6 6 6 0 6 6 6 6 6 6 0 6 0 0 0 0 0 6 6 6 6 6 0 6 6
6 2 7 2 2 2 2 2 2 2 3 3 3 3 3 2 2 2 2 2 2 2 2 0 0 2 2 2 0 0 0 0 0 0 6 6 6 6 0 0 0 0 0 0 0 0 6 0 0 0 0 0 6 6 6 6 6 0 6 6
6 2 7 2 2 2 2 2 2 2 2 2 2 2 2 2 2 2 2 2 2 3 0 0 0 2 2 2 0 0 0 0 0 0 0 6 6 6 6 6 6 6 6 6 6 6 6 6 6 0 0 6 6 4 4 4 4 4 6 6
6 2 7 2 2 2 2 2 2 2 2 2 2 2 2 2 2 2 2 2 3 0 0 0 0 2 2 2 0 0 0 0 0 0 0 6 6 6 6 6 6 6 6 6 6 6 6 6 6 6 0 6 6 4 4 4 4 4 6 6
6 3 7 2 2 2 2 2 2 2 2 2 2 2 2 2 2 2 2 3 3 0 0 0 0 2 2 2 0 0 0 0 0 0 0 6 6 6 6 6 6 6 6 6 6 6 6 4 4 4 4 4 4 4 4 4 4 4 6 6
6 3 3 3 2 2 2 2 2 2 2 2 2 2 2 2 2 2 2 3 0 0 0 0 0 2 2 2 0 0 0 0 0 0 0 0 6 6 4 4 4 4 4 4 4 4 4 4 4 4 4 4 4 4 4 4 4 4 6 6
6 3 3 3 3 3 2 2 2 2 2 2 2 2 2 2 3 3 3 0 0 0 0 0 0 2 2 2 0 0 0 0 0 0 0 0 6 6 4 4 4 4 4 4 4 4 4 4 4 4 4 4 4 4 4 4 4 4 6 6
6 3 3 3 3 3 3 2 2 2 2 2 2 3 3 3 3 0 0 0 0 0 0 0 0 7 7 7 0 0 0 0 0 0 0 0 6 6 4 4 4 4 4 4 4 4 4 4 4 4 4 4 4 4 4 4 4 4 6 6
6 3 3 3 3 3 3 3 2 2 2 2 3 3 3 3 0 0 0 0 0 0 0 0 0 7 7 7 0 0 0 0 0 0 0 0 6 6 4 0 4 4 4 4 4 4 4 4 4 4 4 4 4 4 4 4 4 4 6 6
6 3 3 3 3 3 3 3 3 3 3 3 3 3 3 3 3 3 0 0 0 0 0 0 0 7 7 7 0 0 0 0 0 0 0 0 6 6 4 4 4 4 4 4 4 4 4 4 4 4 4 4 4 4 4 4 4 4 6 6
6 3 3 3 3 3 3 3 3 3 3 3 3 3 3 3 3 3 3 0 0 0 0 0 0 2 2 2 0 0 0 0 0 0 0 0 6 6 4 4 4 4 4 4 4 4 4 4 4 4 4 4 4 4 4 4 4 4 6 6
6 3 3 3 3 3 3 3 3 3 3 3 3 3 3 3 3 3 3 3 0 0 0 0 0 2 2 2 0 0 0 0 0 0 0 0 6 6 4 4 4 4 4 4 4 4 4 4 4 6 6 6 6 6 6 6 6 6 6 6
6 6 6 6 6 6 6 6 6 6 6 6 6 6 6 6 6 6 6 6 6 6 6 6 6 2 2 2 6 6 6 6 6 6 6 6 6 6 6 6 6 6 6 6 6 6 6 6 6 6 6 6 6 6 6 6 6 6 6 6